Date,Description,Amount,Running Balance
9/14/2018,ASPIRATION FUNDS ASP-P                         Sq. Nbr.: 0018719369,-100,2814.7
9/14/2018,CAPITAL ONE      CRCARDPMT                     Sq. Nbr.: 0018722138,-1042.21,2914.7
9/10/2018,Interest Deposit September 2018,0.61,3956.91
9/10/2018,ATM Fee Rebate,3,3956.3
9/10/2018,BARCLAYCARD US   CREDITCARD                    Sq. Nbr.: 0018633014,-102.99,3953.3
9/5/2018,ATM  WITHDRAWAL      7ELEVEN-FCTI              11802 E OSWEGO ST       ENGLEWOOD            CO US,-240,4056.29
9/5/2018,TD AMERITRADE    ACH OUT                       Sq. Nbr.: 0018537233,3000,4296.29
9/4/2018,Pay What Is Fair: Summit Checking,-5,1296.29
